      1111
1111111041
1000002001
1000211021
1121333101
 102333001
 1013031011
 1000101201
 1200200001
 1001111111
 1111
