    11111
    10001
    12001
  11100211
  10020201
1110101101   111111
1000101101111100331
1020020000000000331
1111101110141100331
    100000111111111
    1111111
