111111111111
13300100000111
13300102002001
13300121111001
13300004011001
13300101002011
11111101120201
  102002020201
  100001000001
  111111111111
