        11111111
        10000041
        10212011
        1020021
        1120201
11111111102010111
13333001102002001
11333000020020001
13333001111111111
11111111
