 ########
##@$ .. #
# $#$ *.#
#  $  *.#
# $  #.$#
##  # . #
 #      #
 ########